00000000000000000000000011000000000000000000000000
00000000000000000000000011000000000000000000000000
00000000000000000000000011000000000000000000000000
00000000000000000000000011000000000000000000000000
00000000000000000000000011000000000000000000000000
00000000000000000000000011100000000000000000000000
00000000000000000000000001110000000022222222220000
00000222222222222222000000111000000000000000000000
00000000000000000000000000011100000000000000000000
00000000000000000000000000001100000000000000000000
00000000002000000000000000001100000000000000000000
00000000002000000000000000001100000000000000000000
00000000002000000000000000001100000000000000000000
00000000002000000000000000001100000000000000000000
00000000002000000000000000001110000000000000000000
00000000002000000000000000000111000000000000000000
00000000002000000000000000000011000000000000000000
00000000002000000000000000000001100000000000000000
00000000002000000000000000000001100000000000000000
00000000002000000000000000000011100000000000000000
00000000002000000000000000000111000000000000000000
00000000002000000000000000001110000000000000000000
00000000002000000000000000011100000000000000000000
00000000002000000000000000011000000000000000000000
00000000002000000000000000011000000000000000000000
00000000002000000000000000111110000000000000000000
00000000002000000000000001111111000000000000000000
00000000002000000000000001111111000000000000000000
00000000002000000000000001111111000000000000000000
00000000002000000000000000111110000000000000000000
00000000002000000000000000000000000000000000000000
00000000002000000000000000000000000000000000000000
00000000000000000000000000000000000000002000000000
00000000000000000000000000000000000000002000000000
00000000000000000000000000000000000000002000000000
11100000000000000000000000000000000000102100000000
11111111110000000000000000002000000010102101000000
00111111110000000000000000002000001010102101010000
00000000111000000000000000002000001010102101010101
00000000011100000000000000002000001010102101010101
00000000001100000000000000002000001010102101010101
00000000000110000000000000002000001010102101010101
00000000000110000000000000002000001010102101010101
00000000000110000000000000002000001010102101010101
00000000000110000000000000002000001010102101010101
00000000000111111000000000002000101010111101010101
00000000000111111100000000002000101010100001010101
00000000000000001110000000002000101010111111010101
00000000000000000111000000002001101010100000010101
00000000000000000011000000002001111111111111111111
