00000000000000000000000011000000000000000000000000
00000000000000000000000011000000000000000000000000
00000000000000000000000011000000000000000000000000
00000000000000000000000011000000000000000000000000
00000000000000000000000011000000000000000000000000
00000000000000000000000011100000000000000000000000
00000000000000000000000001110000000022222222220000
00000222222222222222000000111000000000000000000000
00000000000000000000000000011100000000000000000000
00000000000000000000000000001100000000000000000000
00000000002000000000000000001100000000000000000000
00000000002000000000000000001100000000000000000000
00000000002000000000000000001100000000000000000000
00000000002000000000000000001100000000000000000000
00000000002000000000000000001110000000000000000000
00000000002000000000000000000111000000000000000000
00000000002000000000000000000011000000000000000000
00000000002000000000000000000001100000000000000000
00000000002000000000000000000001100000000000000000
00000000002000000000000000000011100000000000000000
00000000002000000000000000000111000000000000000000
00000000002000000000000000001110000000000000000000
00000000002000000000000000011100000000000000000000
00000000002000000000000000011000000000000000000000
00000000002000000000000000011000000000000000000000
00000000002000000000000000111110000000000000000000
00000000002000000000000001111111000000000000000000
00000000002000000000000001111111000000000000000000
00000000002000000000000001111111000000000000000000
00000000002000000000000000111110000000000000000000
00000000000000000000000000000000000000000000000000
00000000000000000000000000000000000000000000000000