00000000000000000000000000000000000000000000000000
00002000000000000000000000000000000000000000000000
00020000000000000000000000000000000000000000000000
00200000000000000000000000000000000000000000020000
02000000000000000000000000000000000000000000020000
00200000022222222222200000000000000000000000020000
00020000022222222222200000000000000000000000020000
00002000022222222222200000000000000000200000020000
00002000022222222222200000000000200000200000020000
00002000022222222222200000000000200000200000020000
00002000022222222222200000000000200000200000020000
00002000022222222222200000000000200000200000020000
00002000022222222222200000000000200000200000020000
00002000022222222222200000000000200000200000020000
00002000022222222222200000000000200000200000020000
00002000022222222222200000000000200000200000020000
00000000022222222222200000000000200000200000020000
00000000000000000000000000000000200000200000020000
00000000000000000000000000000000200000200000020000
00000000000000000000000000000000200000200000020000
00000000000000000000000000000000000000200000020000
00000000000000000000000000000000000000200000020000
00000000000022222222222200002222222222200000020000
00000000000000000200000000022222222222200000020000
00000000000000000200000000020000000000000000020000
00000000000000000200000000020000000000000000000000
00000000000000000200000000020000000000000000000000
00000000000000000200000000020000000000000000000000
00000000000000000200000000020000000000000000000000
00000000000000000200000000020000000000000000000000
00000000000000000200000000000000000000000000000000
00000000000000000200000000000000000000000000000000
