00000000000000000000000000000000000000000000000000
00000000000000000000000000000000000000000000000000
00000000000000000000000000111000000000000000000000
00000000000000000000000000111110000000000000000000
00000000000000000000000000111111111111100000000000
00000000000000000000000000011111111111100000000000
00000000000000000000000000011111111111100000000000
00000000000000000000000020011011110111100000000000
00000000020000001100000020011011100011100000000000
00000000020000011110000020011000100011100000000000
00000000020000011110000020010000100010000000000000
00000000020000111111100020110000100010000000000000
00000000020000111111000020110001000011000000000000
00000000020000111110000020110010000001000000020000
00000000020000011111000020110000000000000000200000
00000000020000001111000020110000000000000002000000
00000000020000000111100020110000000000000020000000
00000000020000000001100020111110000000000200000000
00000000020000000001000020011110000000002000000000
00000000000000000000000020011110000200000000000000
00000000000000000000000020011110000020000000000000
00000000000000000000000000011111000002000000000000
00000000000000000000000000000011000000200000000000
00000000000000000000000002222011000000020000000000
00000000000000000000000002222011000000000000000000
00000222222200222222200002222011000000000000000000
00000222222200222222200000000011000000000000000000
00000222222200222222200000000011000000000000000000
00000222222200222222200002200011000000000000000000
00000000000000000000000002200011000000000000000000
00000000000000000000000002200011000000000000000000
00000000000000000000000000000011000000000000000000
