00000000000000000000000000000000000000000000000000
00000000000000000111000000000000000011110000000000
00000000000001111111000000000000000011111000000000
00000011111111111111111111110000000000111000000000
00000111111111111111111111110000000000011000000000
00001111111111111111111111110000000000011000000000
00001111111111111111111111111110000000011000000000
00001111111111111111111111111110000000011000000000
00001111111111111111111111111110000000011000000000
00001111111111111111111111111110000000011000000000
00011111111111111111111111110000000000011000000000
00011111111111111111111111111111100000011000000000
00011111111111111111111111111111100000011000000000
00011111111111111111111111111111100000011100000000
00011111111111111111111111111111100000001100000000
00011111111111111111111111111111100000000000000000
00011111111111111111111111111111100000000000000000
00011111111111111111111111110000000000000000000000
00011111111111111111111111110000000001111000000000
00000011111111111111111111110000000001111110000000
00000000111111111111111110000000000111111110000000
00000000111111111111111110000000000111111110000000
00000000111111111111111110000000000111111110000000
00000000111111111111111110000000000111111000000000
00000000000000011111100000000000000111111100000000
00000000000000000111100000000000000111111100000000
00000000000000000000000000000000000011111100000000
00000000000000000000000000000000000011111100000000
00000000000000000000000000000000000000011100000000
00000000000000000000000000000000000000000000000000
00000000000000000000000000000000000000000000000000
00000000000000000000000000000000000000000000000000
